%%%%%%%%%%%
%%%%%%%%%%%
%%%%%%%%%%%
%%%%%......
%%%%%......
%%%%%......
%%%%%%%%%%%
%%%%%%%%%%%
#
%%%%%%%%%%%
%%%%%%%%%%%
%%%%%%%%.%%
%%%P%%%...%
%%%%%%.....
%%%%%%%...%
%%%%%%%%.%%
%%%%%%%%%%%
#
%%%%%%%%%%%
%%%%%%%...%
%%%%%%%...%
%%%%%%%...%
%%%%%%%...%
%%%%%%%...%
%%%%%%%...%
%%%%%%%...%
#
