%%%%%%%%%%%%%%%%%%%%%%%%%%%%%%%%%%%%%%%%%%%%%%%%%%%%%%%%
%%%%%%%%%%%%%%%%%%%%%%%%%%%%%%%%%%%%%%%%%%%%%%%%%%%%%%%%
%%%%%%%%%%%%%%%%%%%%%%%%%%%%%%%%%%%%%%%%%%%%%%%%%%%%%%%%
%%%%%%%%%%%%%%%%%%%%%%%%%%%%%%%%%%%%%%%%%%%%%%%%%%%%%%%%
%%%%%%%%%%%%%%                       %%%%%%%%%%%%%%%%%%%
%%%%%%%%%%%%%%                       %%%%%%%%%%%%%%%%%%%
%%%%%%%%%%%%%%                       %%%%%%%%%%%%%%%%%%%
%%%%%%%%%%%%%%                       %%%%%%%%%%%%%%%%%%%
%%%%%%%%%%%%%%                       %%%%%%%%%%%%%%%%%%%
%%%%%%%%%%%%%%                       %%%%%%%%%%%%%%%%%%%
%%%%%%%%%%%%%%                       %%%%%%%%%%%%%%%%%%%
%%%%%%%%%%%%%%                       %%%%%%%%%%%%%%%%%%%
%%%%%%%%%%%%%%                       %%%%%%%%%%%%%%%%%%%
%%%%%%%%%%%%%%             ..........%%%%%%%%%%%%%%%%%%%
%%%%%%%%%%%%%%            ...........%%%%%%%%%%%%%%%%%%%
%%%%%%%%%%%%%%           ............%%%%%%%%%%%%%%%%%%%
%%%%%%%%%%%%%%          .............%%%%%%%%%%%%%%%%%%%
%%%%%%%%%%%%%%         ..............%%%%%%%%%%%%%%%%%%%
%%%%%%%%%%%%%%         ..............%%%%%%%%%%%%%%%%%%%
%%%%%%%%%%%%%%         ..............%%%%%%%%%%%%%%%%%%%
%%%%%%%%%%%%%%         ..............%%%%%%%%%%%%%%%%%%%
%%%%%%%%%%%%%%         ..............%%%%%%%%%%%%%%%%%%%
%%%%%%%%%%%%%%         ..............%%%%%%%%%%%%%%%%%%%
%%%%%%%%%%%%%%         ..............%%%%%%%%%%%%%%%%%%%
%%%%%%%%%%%%%%          .............%%%%%%%%%%%%%%%%%%%
%%%%%%%%%%%%%%           ............%%%%%%%%%%%%%%%%%%%
%%%%%%%%%%%%%%            ...........%%%%%%%%%%%%%%%%%%%
%%%%%%%%%%%%%%             ..........%%%%%%%%%%%%%%%%%%%
%%%%%%%%%%%%%%                       %%%%%%%%%%%%%%%%%%%
%%%%%%%%%%%%%%                       %%%%%%%%%%%%%%%%%%%
%%%%%%%%%%%%%%                       %%%%%%%%%%%%%%%%%%%
%%%%%%%%%%%%%%                       %%%%%%%%%%%%%%%%%%%
%%%%%%%%%%%%%%                       %%%%%%%%%%%%%%%%%%%
%%%%%%%%%%%%%%                       %%%%%%%%%%%%%%%%%%%
%%%%%%%%%%%%%%                       %%%%%%%%%%%%%%%%%%%
%%%%%%%%%%%%%%                       %%%%%%%%%%%%%%%%%%%
%%%%%%%%%%%%%%                       %%%%%%%%%%%%%%%%%%%
%%%%%%%%%%%%%%%%%%%%%%%%%%%%%%%%%%%%%%%%%%%%%%%%%%%%%%%%
%%%%%%%%%%%%%%%%%%%%%%%%%%%%%%%%%%%%%%%%%%%%%%%%%%%%%%%%
%%%%%%%%%%%%%%%%%%%%%%%%%%%%%%%%%%%%%%%%%%%%%%%%%%%%%%%%
%%%%%%%%%%%%%%%%%%%%%%%%%%%%%%%%%%%%%%%%%%%%%%%%%%%%%%%%
%%%%%%%%%%%%%%%%%%%%%%%%%%%%%%%%%%%%%%%%%%%%%%%%%%%%%%%%
%%%%%%%%%%%%%%%%%%%%%%%%%%%%%%%%%%%%%%%%%%%%%%%%%%%%%%%%
#
%%%%%%%%%%%%%%%%%%%%%%%%%%%%%%%%%%%%%%%%%%%%%%%%%%%%%%%%
%%%%%%%%%%%%%%%%%%%%%%%%%%%%%%%%%%%%%%%%%%%%%%%%%%%%%%%%
%%%%%%%%%%%%%%%%%%%%%%%%%%%%%%%%%%%%%%%%%%%%%%%%%%%%%%%%
%%%%%%%%%%%%%%%%%%%%%%%%%%%%%%%%%%%%%%%%%%%%%%%%%%%%%%%%
%%%%%%%%%%%%%%%%%%%%%%%%%%%%%%%%%%%%%%%%%%%%%%%%%%%%%%%%
%%%%%%%%%%%%%%%%%%%%%%%%%%%%%%%%%%%%%%%%%%%%%%%%%%%%%%%%
%%%%%%%%%%%%%%%%%%%%%%%%%%%%%%%%%%%%%%%%%%%%%%%%%%%%%%%%
%%%%%%%%%%%%%%%%%%%%%%%%%%%%%%%%%%%%%%%%%%%%%%%%%%%%%%%%
%%%%%%%%                                    %%%%%%%%%%%%
%%%%%%%%                                .   %%%%%%%%%%%%
%%%%%%%%                               ...  %%%%%%%%%%%%
%%%%%%%%                              ..... %%%%%%%%%%%%
%%%%%%%%                             .......%%%%%%%%%%%%
%%%%%%%%                            ........%%%%%%%%%%%%
%%%%%%%%                           .........%%%%%%%%%%%%
%%%%%%%%       P                  ..........%%%%%%%%%%%%
%%%%%%%%                         ...........%%%%%%%%%%%%
%%%%%%%%                        ............%%%%%%%%%%%%
%%%%%%%%                       .............%%%%%%%%%%%%
%%%%%%%%                      ..............%%%%%%%%%%%%
%%%%%%%%                     ...............%%%%%%%%%%%%
%%%%%%%%                      ..............%%%%%%%%%%%%
%%%%%%%%                       .............%%%%%%%%%%%%
%%%%%%%%                        ............%%%%%%%%%%%%
%%%%%%%%                         ...........%%%%%%%%%%%%
%%%%%%%%                          ..........%%%%%%%%%%%%
%%%%%%%%                           .........%%%%%%%%%%%%
%%%%%%%%                            ........%%%%%%%%%%%%
%%%%%%%%                             .......%%%%%%%%%%%%
%%%%%%%%                              ..... %%%%%%%%%%%%
%%%%%%%%                               ...  %%%%%%%%%%%%
%%%%%%%%                                .   %%%%%%%%%%%%
%%%%%%%%                                    %%%%%%%%%%%%
%%%%%%%%                                    %%%%%%%%%%%%
%%%%%%%%%%%%%%%%%%%%%%%%%%%%%%%%%%%%%%%%%%%%%%%%%%%%%%%%
%%%%%%%%%%%%%%%%%%%%%%%%%%%%%%%%%%%%%%%%%%%%%%%%%%%%%%%%
%%%%%%%%%%%%%%%%%%%%%%%%%%%%%%%%%%%%%%%%%%%%%%%%%%%%%%%%
%%%%%%%%%%%%%%%%%%%%%%%%%%%%%%%%%%%%%%%%%%%%%%%%%%%%%%%%
%%%%%%%%%%%%%%%%%%%%%%%%%%%%%%%%%%%%%%%%%%%%%%%%%%%%%%%%
%%%%%%%%%%%%%%%%%%%%%%%%%%%%%%%%%%%%%%%%%%%%%%%%%%%%%%%%
%%%%%%%%%%%%%%%%%%%%%%%%%%%%%%%%%%%%%%%%%%%%%%%%%%%%%%%%
%%%%%%%%%%%%%%%%%%%%%%%%%%%%%%%%%%%%%%%%%%%%%%%%%%%%%%%%
%%%%%%%%%%%%%%%%%%%%%%%%%%%%%%%%%%%%%%%%%%%%%%%%%%%%%%%%
#
%%%%%%%%%%%%%%%%%%%%%%%%%%%%%%%%%%%%%%%%%%%%%%%%%%%%%%%%
%%%%%%%%%%%%%%%%%%%%%%%%%%%%%%%%%%%%%%%%%%%%%%%%%%%%%%%%
%%%%%%%%%%%%%%%%%%%%%%%%%%%%%%%%%%%%%%%%%%%%%%%%%%%%%%%%
%%%%%%%%%%%%%%%%%%%%%%%%%%%%%%%%%%%%%%%%%%%%%%%%%%%%%%%%
%%%%%%%%%%%%%%%%%%%%%%%%%%%%%%%%%%%%%%%%%%%%%%%%%%%%%%%%
%%%%%%%%%%%%%%%%%%%%%%%%%%%%%%%%%%%%%%%%%%%%%%%%%%%%%%%%
%%%%%%%%%%%%%%%%%%%%%%%%%%%%%%%%%%%%%%%%%%%%%%%%%%%%%%%%
%%%%%%%%%%%%%%%%%%%%%%%%%%%%%%%%%%%%%%%%%%%%%%%%%%%%%%%%
%%%%%%%%%%%%%%%%%%%%%%%%%%%%%%%%%%%%%%%%%%%%%%%%%%%%%%%%
%%%%%%%%%%%%%%%%%%%%%%%%%%%%%%%%%%%%%%%%%%%%%%%%%%%%%%%%
%%%%%%%%%%%%%%%%%%%%%%%%%%%%%%%%%%%%%%%%%%%%%%%%%%%%%%%%
%%%%%%%%%%%%%%%%%%%%%%%%%%%%%%%%%%%%%%%%%%%%%%%%%%%%%%%%
%%%%%%%%%%%%%%%%%%%%%%%%%%%%%%%%%%%%%%%%%%%%%%%%%%%%%%%%
%%%%%%%%%%%%%%%%%%%%%%%%%%%%%%%%%%%%%%%%%%%%%%%%%%%%%%%%
%%%%                             ..............%%%%%%%%%
%%%%                             ..............%%%%%%%%%
%%%%                             ..............%%%%%%%%%
%%%%                             ..............%%%%%%%%%
%%%%                             ..............%%%%%%%%%
%%%%                             ..............%%%%%%%%%
%%%%                             ..............%%%%%%%%%
%%%%                             ..............%%%%%%%%%
%%%%                             ..............%%%%%%%%%
%%%%                             ..............%%%%%%%%%
%%%%                             ..............%%%%%%%%%
%%%%                             ..............%%%%%%%%%
%%%%                             ..............%%%%%%%%%
%%%%%%%%%%%%%%%%%%%%%%%%%%%%%%%%%%%%%%%%%%%%%%%%%%%%%%%%
%%%%%%%%%%%%%%%%%%%%%%%%%%%%%%%%%%%%%%%%%%%%%%%%%%%%%%%%
%%%%%%%%%%%%%%%%%%%%%%%%%%%%%%%%%%%%%%%%%%%%%%%%%%%%%%%%
%%%%%%%%%%%%%%%%%%%%%%%%%%%%%%%%%%%%%%%%%%%%%%%%%%%%%%%%
%%%%%%%%%%%%%%%%%%%%%%%%%%%%%%%%%%%%%%%%%%%%%%%%%%%%%%%%
%%%%%%%%%%%%%%%%%%%%%%%%%%%%%%%%%%%%%%%%%%%%%%%%%%%%%%%%
%%%%%%%%%%%%%%%%%%%%%%%%%%%%%%%%%%%%%%%%%%%%%%%%%%%%%%%%
%%%%%%%%%%%%%%%%%%%%%%%%%%%%%%%%%%%%%%%%%%%%%%%%%%%%%%%%
%%%%%%%%%%%%%%%%%%%%%%%%%%%%%%%%%%%%%%%%%%%%%%%%%%%%%%%%
%%%%%%%%%%%%%%%%%%%%%%%%%%%%%%%%%%%%%%%%%%%%%%%%%%%%%%%%
%%%%%%%%%%%%%%%%%%%%%%%%%%%%%%%%%%%%%%%%%%%%%%%%%%%%%%%%
%%%%%%%%%%%%%%%%%%%%%%%%%%%%%%%%%%%%%%%%%%%%%%%%%%%%%%%%
%%%%%%%%%%%%%%%%%%%%%%%%%%%%%%%%%%%%%%%%%%%%%%%%%%%%%%%%
%%%%%%%%%%%%%%%%%%%%%%%%%%%%%%%%%%%%%%%%%%%%%%%%%%%%%%%%
%%%%%%%%%%%%%%%%%%%%%%%%%%%%%%%%%%%%%%%%%%%%%%%%%%%%%%%%
%%%%%%%%%%%%%%%%%%%%%%%%%%%%%%%%%%%%%%%%%%%%%%%%%%%%%%%%
#
