%%%%%%%%%%%%%
%%%%%%%%%%%%%
%%%%%%%%%%%%%
%%%%%%%%%%%%%
%%%%%%.......
%%%%%%.......
%%%%%%.......
%%%%%%%%%%%%%
%%%%%%%%%%%%%
%%%%%%%%%%%%%
#
%%%%%%%%%%%%%
%%%%%%%%%%%%%
%%%%%%%%%%%%%
%%%P%%%%%%.%%
%%%%%%%%%...%
%%%%%%%%.....
%%%%%%%%%...%
%%%%%%%%%%.%%
%%%%%%%%%%%%%
%%%%%%%%%%%%%
#
%%%%%%%%%%%%%
%%%%%%%%%...%
%%%%%%%%%...%
%%%%%%%%%...%
%%%%%%%%%...%
%%%%%%%%%...%
%%%%%%%%%...%
%%%%%%%%%...%
%%%%%%%%%...%
%%%%%%%%%...%
#
