%%%%%%%%%%%%%%%%%%%%%%
%%%%%%%%%%%%%%%%%%%%%%
%%%%%%%%%%%%%%%%%%%%%%
%%%%%%%%%%%%%%%%%%%%%%
%%%%%%%%%%%%%%%%%%%%%%
%%%%%%%%%%%%.........%
%%%%%%%%%%............
%%%%%%%%%%............
%%%%%%%%%.............
%%%%%%%%%%............
%%%%%%%%%%............
%%%%%%%%%%%%.........%
%%%%%%%%%%%%%%%%%%%%%%
%%%%%%%%%%%%%%%%%%%%%%
%%%%%%%%%%%%%%%%%%%%%%
%%%%%%%%%%%%%%%%%%%%%%
%%%%%%%%%%%%%%%%%%%%%%
#
%%%%%%%%%%%%%%%%%%%%%%
%%%%%%%%%%%%%%%%%%%%%%
%%%%%%%%%%%%%%%%%%%%%%
%%%%%%%%%%%%%%%%%%%%%%
%%%%%%%%%%%%%%%%.%%%%%
%%%%%%%%%%%%%%%...%%%%
%%%%%%P%%%%%%%.....%%%
%%%%%%%%%%%%%.......%%
%%%%%%%%%%%%.........%
%%%%%%%%%%%%%.......%%
%%%%%%%%%%%%%%.....%%%
%%%%%%%%%%%%%%%...%%%%
%%%%%%%%%%%%%%%%.%%%%%
%%%%%%%%%%%%%%%%%%%%%%
%%%%%%%%%%%%%%%%%%%%%%
%%%%%%%%%%%%%%%%%%%%%%
%%%%%%%%%%%%%%%%%%%%%%
#
%%%%%%%%%%%%%%%%%%%%%%
%%%%%%%%%%%%%%%%.%%%%%
%%%%%%%%%%%%%%.....%%%
%%%%%%%%%%%%%%.....%%%
%%%%%%%%%%%%%.......%%
%%%%%%%%%%%%%.......%%
%%%%%%%%%%%%%.......%%
%%%%%%%%%%%%%.......%%
%%%%%%%%%%%%%.......%%
%%%%%%%%%%%%%.......%%
%%%%%%%%%%%%%.......%%
%%%%%%%%%%%%%.......%%
%%%%%%%%%%%%%.......%%
%%%%%%%%%%%%%%.....%%%
%%%%%%%%%%%%%%.....%%%
%%%%%%%%%%%%%%%%.%%%%%
%%%%%%%%%%%%%%%%%%%%%%
#
